9
7
 11   11
1111 1111
111111111
 1111111
  11111
   111
    1