10
10
    11
   1111
  111111
  111111
  111111
1111111111
1111111111
  111111
  111111
  111111