7
9
11111
11   11
11   11
11  11
1111
11  11
11   11
11   11
11111