10
10
  11111
 11   11
11     11
      11
     11
      11
        11
11      11
 11    11
  11111