9
10
  11111
 11   11
11
11
11
11 111
111   11
11     11
 11   11
  11111
     