8
6
   11
 11  11
11    11
11111111
11    11
11    11