13
13
        1111
        1111
     1111111
   111   111
  1111111111
1111    1111
111111111111
1111    1111
11111 
11  11111111
11111   1111
11  11111111
111111111111