11
11
  11111
 1111111
11     11
11
11
11   111111
11   111111
11     11
11     11
 1111111
  11111