7
8
11   11
11   11
11   11
1111111
1111111
11   11
11   11
11   11