11
6
  111111
 11111111
11 1111 11
1111111111
 111  111
  111111