7
9
1111
11 11  
11  11 
11   11
11   11
11   11
11  11 
11 11
1111  